The Deathless King: Burkhart the Uniter
King 1: King Godric
King 2: King Lowell
King 3: King Ephraim II
King 4: King Lachran
King 5: King Architer IV
Spider Girl: Joleanna
Dark Contractor: Yorus
Three Peeps: Yoric, Biri, Zacharias
Northern Kingdoms: Kings' Alliance
Elven Kingdom:
Dwarven Kingdom: 
People of the West:
Crazy Wizard: Johnathan the Great
Dealer: Tagranan
Devil: Morkon
Archer Girl: Annette
Leader: Arondor 
Merchant: Jessie Prewett
Orc: Xorag the Sword Breaker
Orc party leader: Alog
Dragonborn Capitan: Medrash
Chief: Chultoi
Lord of Dark Hollow: Lord Downland
City: Heartkeep
Cleric: Father Willard
Father Willard's God: Atesis
Big Arcana
Tanner: Emod
Great City: Ka'Imbo
Spectator: Shlox
Devil Merchant: Velron
High End Pub: Odd Oak Pub & Inn
Wiz: Ergranova
Annette's Mom: Nia
Annette's Dad: Kesdek
Wolf town: Ethermoor
Rave Wizard 1 Pink Robes: Xaphiar
Rave Wizard 2 Chicken Hair: Wokius                        !!!
Rave Wizard 3 Starry Form: Thurhan
Proffessor of Magical Artifacts: Proffessor Eflyn
Partygoer: Jonak
Merchant: Vurcoldir Sargendal
Drugs: Third Eye, Goldthistle
Div Wiz: Valune
General: Twinkletoes
ID place: Krondor's Identifacation
City 2 EB: Qester
Border town: Adamont
Mountain: Kryethune
Cpt of the guard: Sir Landon
Gorgon Town: Brickelwhyte
I'm sad city: Criudeni
Inn in Criudeni: Seaway Inn
Elf Family: Holimion
Holimion Swordsmen: Francis & Peter
Keeper of the Seaway Inn: Dranis Holimion
Orc Leader II: Yolmar the Razer
Zamfrar's family: Patricia and Domineq
Small Village: Last Stop
Large Village: Port Drogan
Sailor 1: Criofan Ã“ Fearghail
PD Inn W/ Scratch: Pirate's Bay
Tabaxi Sailor: The Scratching Of Squirrels In Trees 'Scratch'
White Dragon: Ulshgondir
'Medusa': Anastasia
Stoned 1: Timothy Crank (Excited) 510
Stoned 2: Captain Mungus Johnson of the 23rd (Old soldier) 23
Stoned 3 & 4: Private Francis & O'Hara
Stoned 5: Charles Branson, the one and only (adventure on the high seas) 449
Stoned 6: Gloria Forvain 498
Company: Brandy, Clarence, and Fredrick
Stoned 7: Fredrick Forvain 498
Stoned 8: Crash 389 (Barbarian)
Stoned 9: Kimra Armik 407
Northern Range: Thunderwave Peaks
Goliath Village: Ogra-Anor
Goliath: Gerike
G2: Meavith (Me awv ith)
G3: Kuothe (Kew oeth)
G4: Dragot (Dray got)
Orcless town: Wintervale
Lord of Wintervale: Brillyo
Orc town: Eymeet
Dwarf?: Dig Bick
Goliath Child: Tauk
540,000 soldiers
Message: We await in death the time when we can again serve our deathless king.
Kennelmaster: Brock
Dogs: Auvith, Lamak, Vaukon, Brenar, Veni, Nivu
Capitol: Lunor
Elder: Pughan
World?: Daulin; Mantequilla
Baker: Brent
Year in south (old): 1233
Juliard Simperson
Granto, Granis
Gruce
City I forgot: Yaford
Drow fuck: vith
Crown City: Anna Shaeras
The Cuirass of Burkheart is deep below the city of Lilenshara in a "chamber devoted to the cause"
Doorkeeper: Nylian Miaric, Master Doorkeeper of Anna Shaeras
High Queen: Arel Loralana
Keltia temple city: Kyselon
Home temple town: Lyrangroth
Head Guard: Tam Chyademra
Traveling artifact specialist: Regren Silverdrifter
Inn: Blue Box
Halftown: Llyn
Halftown 2 EB: Squelllake
Lord of Wyvern's Pass: Brairn
Soldier 1: Memar Bholud
Sherif: Pimvias
Andry: Evil Dude
Pants Man: 
Cpt.: Gorter 
Sean's Number: 9166986369
Stop 1: Croydon
Drugs: Silver Milk, Dwarf Ash
Ship: Rambler II
Barkara
Kagaro
Hariadra
Frianto
Grazatori/Grazaturi(-oori)
Arboshina
Fear Knight: Archlegate Milena Orsolya Iuncina
Lord Banno
Norrin Amberstride
Rizne Khassul
Wilfer Glowwillow
Finhorn Glowwillow
Town: Burry
Seranor - contanent?, world?